###############
#X  #         #
# # # # ### ###
# ### # # # # #
#     # # # # #
####### # #   #
#         # ###
## ######## # #
#  #          #
#### ### ######
#    #       X#
###############