#####################################
#O#       #       #     #         # #
# # ##### # ### ##### ### ### ### # #
#       #   # #     #     # # #   # #
##### # ##### ##### ### # # # ##### #
#   # #       #     # # # # #     # #
# # ####### # # ##### ### # ##### # #
# #       # # #   #     #     #   # # 
# ####### ### ### # ### ##### # ### # 
#     #   # #   # #   #     # #     #
# ### ### # ### # ##### # # # #######
#   #   # # #   #   #   # # #   #   #
####### # # # ##### # ### # ### ### #
#     # #     #   # #   # #   #     #
# ### # ##### ### # ### ### ####### #
# #   #     #     #     # #       # #
# # ##### # ### ##### # # ####### # #
# #     # # # # #     #       # #   #
# ##### # # # ### ##### ##### # #####
# #   # # #     #     # #   #       #
# # ### ### ### ##### ### # ##### # #
#X#         #     #       #       # #
#####################################