#####################################
#O  #         #            ##   #   #
# # # # ### ######### ####    #   # #
# ### # # # # #          #### #######
#     # # # # # #### ### #          #
####### # #   #    #   # # # ########
#         # ###### # # # # # # # #  #
## ######## # #    # # #   # #    # #
#  #          # #### ####### # ## # #
#### ### ###### # #          #  #   #
#    #          # # # ######### ### #
#################   # # #         # #
#   #   #   #   ##### # # #### ## ###
# ### # # #   #       #   #         #
#     # # ##### ####### ### ##### ###                                   
##### ### #     # #   # #     #     #
#  #      # #####   # # ########### #
#  # ###### # # ## ## #    #   #    #
# ## # #    #       # # #### # # ####
#    # # ##### #### #   #    # #    #
####   # #   # #  # ##### #### ### ##
#    # #   #   #          #        X#
#####################################